WOOOOOOOWOOOOOOOOW
OEWWWWOOWWWWWWWWWW
OOOOOOOOOOOOOOOOOW
WOOWOOOOOWOOOOOOOOW
WOOWWWWOOWWWWWWWWWW
WOOOOOOOOWOOOOOOOOW
WOOWOOOOOWOOOOOOOOW
WOOWWWWOOWWWWWSWWWW
WOOOOOOOOWOOOOOOOOW