WWWWWWWWWWW
WOOOWOOOWOW
WOWOWWWOWOW
WOWOOOOOWOW
WOWWWWWWWOW
SOWOOOWOOOW
WOWOWOWOWOW
WOWOWOWOWOW
WOWWWOWOWWW
WOOOWOWOOOW
WWWOWOWOWOW
WOWOOOWOEOW
WOWOWWWWWOW
WOWOOOOOOOW
WOWOWWWWWWW
