SWWWOWWWWW
OOOOOWOOOW
OWOWOWOWOW
OWOWOOOWOW
OOOWOWWOOW
WWOWOOWOWW
WOOOWOWOOO
WOWOOOWOWO
WOWWOWWOWO
EOOOOWWOWW
