WOOWWWWWWWOOWWWWOOW
WOOOOOOOOWOOWOOOOOW
WWWWOOWOOWOOWOOWWWW
WOOOOOOOOWOOWOOOOOW
WOOOOOOOOWOOWOOOOOW
WWWWOOWOOWOOWOOWWWS
WOOOOOOOOWOOWOOOOOE
WWWWOOWOOWOOWOOWWWW