WEOWWWWWWWOOWWWWOOW
WOOOOOOOOWOOWOOOOOW
WWWWOOWOOWOOWOOWWWW
WOOWWWWOWWOOWWWWOOW
WOOOOOOOOWOOWOOOOOW
WWWWOOWOOWOOWOOWWWW
WOOWWWWWWWOOWWWWOOW
WOOOOOOOOWOOWOOOOOW
WWWWOOWOOSOOWOOWWWW