WWWWWWWWWWWWWWWWWWW
OOOOOOOSOOOOWOOOOOW
WOOWWWWWWWOOWOOWOOW
WOOOOOOOOWOOOOOWOOW
WOOWOOOOOWOOOOOOOOW
WOOWWWWOOWWWWWWWWWW
WOOOOOOOOWOOOOOOOOW
WOOWWWWWWWOOWWWWOOW
WOOOOOOOOWOOWOOOOOW
WWWWOOWOOWOOWOOWWWW
WWWWOOOWWWW
OOWOOOOEOOO
OWOOWOOWOOW