WWWWOWWWWW 
OOOOOWOOOW 
OWOWOWSWOW 
OWOWOOOWOW 
OOOWOWWOOW 
WWOOOOWOWW 
WOWOWOWOOO 
WOWEOOOOWO 
WOWWOWWOWO 
WOOOOWWOWW 